1111111111111111111111111111111111
1E000P0000000000000000000000000001
1010010100100000101001000000010101
101001001010101000100100C000010101
1000000000000000000000000000000001
1111111111111111111111111111111111
1111111111111111111111111111111111
1E00000000000000000000000000000001
1010010100100000101001000000010101
101001001010101000100100C000010101
1000000000000000000000000000000001
1111111111111111111111111111111111
1111111111111111111111111111111111
1E00000000000000000000000000000001
1010010100100000101001000000010101
101001001010101000100100C000010101
1000000000000000000000000000000001
1111111111111111111111111111111111
1111111111111111111111111111111111
1E00000000000000000000000000000001
1010010100100000101001000000010101
101001001010101000100100C000010101
1000000000000000000000000000000001
1111111111111111111111111111111111
1111111111111111111111111111111111
1E00000000000000000000000000000001
1010010100100000101001000000010101
101001001010101000100100C000010101
1000000000000000000000000000000001
1111111111111111111111111111111111
1111111111111111111111111111111111
1E00000000000000000000000000000001
1010010100100000101001000000010101
101001001010101000100100C000010101
1000000000000000000000000000000001
1111111111111111111111111111111111
1111111111111111111111111111111111
1E00000000000000000000000000000001
1010010100100000101001000000010101
101001001010101000100100C000010101
1000000000000000000000000000000001
1111111111111111111111111111111111
1111111111111111111111111111111111
1E00000000000000000000000000000001
1010010100100000101001000000010101
101001001010101000100100C000010101
1000000000000000000000000000000001
1111111111111111111111111111111111
1111111111111111111111111111111111
1E00000000000000000000000000000001
1010010100100000101001000000010101
101001001010101000100100C000010101
1000000000000000000000000001
1111111111111111111111111111111111