111111111111111111111111111
100000000000011100011100001
1000E0000000011100011100001
100000000000011111000000001
100000000000000000000000001
100000P000000P0000C11000001
111111111111111111111111111